{
  "bedroom": {
    "img": "assets/house/red_room_2f.png",
    "cols": 20,
    "rows": 15,
    "blocked": [
      [1,1,1,1,1,1,1,1,1,1,1,1,1,1,1,1,1,1,1,1],
      [1,1,1,1,1,1,1,1,1,1,1,1,1,1,1,1,1,1,1,1],
      [1,1,1,1,1,1,1,1,1,1,1,1,1,1,1,1,1,1,1,1],
      [1,1,1,1,1,1,1,1,0,1,1,0,0,1,1,1,1,1,1,1],
      [1,1,1,0,0,0,0,0,0,1,1,0,0,1,1,1,1,1,1,1],
      [1,1,1,0,0,0,0,0,0,0,0,0,0,1,1,1,1,1,1,1],
      [1,1,1,0,0,0,0,1,1,0,0,0,0,1,1,1,1,1,1,1],
      [1,1,1,0,0,0,0,1,1,0,0,0,0,1,1,1,1,1,1,1],
      [1,1,1,0,0,0,0,0,0,0,0,0,0,1,1,1,1,1,1,1],
      [1,1,1,1,1,1,0,0,0,0,0,0,0,1,1,1,1,1,1,1],
      [1,1,1,1,1,1,0,0,0,0,0,0,0,1,1,1,1,1,1,1],
      [1,1,1,1,1,1,1,1,1,1,1,1,1,1,1,1,1,1,1,1],
      [1,1,1,1,1,1,1,1,1,1,1,1,1,1,1,1,1,1,1,1],
      [1,1,1,1,1,1,1,1,1,1,1,1,1,1,1,1,1,1,1,1],
      [1,1,1,1,1,1,1,1,1,1,1,1,1,1,1,1,1,1,1,1]
    ],
    "start": [8, 9],
    "warps": [
      {"x": 10, "y": 4, "to": "living", "ax": 4, "ay": 5, "dir": "up", "face": "down", "kind": "stairs", "climb": [0, -1]}
    ]
  },
  "living": {
    "img": "assets/house/red_living_1f_stairs.png",
    "cols": 20,
    "rows": 15,
    "blocked": [
      [1,1,1,1,1,1,1,1,1,1,1,1,1,1,1,1,1,1,1,1],
      [1,1,1,1,1,1,1,1,1,1,1,1,1,1,1,1,1,1,1,1],
      [1,1,1,1,1,1,1,1,1,1,1,1,1,1,1,1,1,1,1,1],
      [1,1,1,1,1,0,0,0,0,0,0,0,0,1,1,1,1,1,1,1],
      [1,1,1,1,1,0,0,0,0,0,0,0,0,1,1,1,1,1,1,1],
      [1,1,1,0,0,1,0,0,0,0,0,0,0,0,0,0,0,1,1,1],
      [1,1,1,1,0,1,0,0,0,0,0,0,0,0,0,0,0,1,1,1],
      [1,1,1,1,0,1,0,0,0,0,0,0,0,0,0,0,0,1,1,1],
      [1,1,1,0,0,0,0,0,0,0,0,0,0,0,1,1,1,1,1,1],
      [1,1,1,0,0,0,0,0,0,0,0,0,0,0,1,1,1,1,1,1],
      [1,1,1,0,0,0,0,0,0,0,0,0,0,0,0,0,0,1,1,1],
      [1,1,1,1,1,1,1,1,1,1,1,1,1,1,1,1,1,1,1,1],
      [1,1,1,1,1,1,1,1,1,1,1,1,1,1,1,1,1,1,1,1],
      [1,1,1,1,1,1,1,1,1,1,1,1,1,1,1,1,1,1,1,1],
      [1,1,1,1,1,1,1,1,1,1,1,1,1,1,1,1,1,1,1,1]
    ],
    "start": [9, 9],
    "warps": [
      {"x": 4, "y": 4, "to": "bedroom", "ax": 10, "ay": 5, "dir": "left", "face": "down", "kind": "stairs", "climb": [-1, -1]},
      {"x": 8, "y": 11, "to": "world", "dir": "down", "kind": "door"},
      {"x": 9, "y": 11, "to": "world", "dir": "down", "kind": "door"}
    ]
  }
}
